2 13 31
###############################
#p     ** *  1 * 2 *  * * *   #
# # # #*# # #*#*# # # #*#*#*# #
#  sbfb   ***  *  1   * 2 * * #
# # # # # #*# # #*#*# # # # #*#
#f 3 4  5  * **  *  *   1     #
# # # # # # # # # #*# #*# # # #
#*  * 2    *  *       5       #
# # # # #*# # # #*#*# # # # # #
#*    **  *       *           #
# #*# # # # # # #*# # # # # # #
#   s       *   *  *        x #
###############################
